1111111111
1P00000001
1000011001
1000011001
1000011001
1000000001
1111111111
10CC000E01
1111111111
