1111111111
1P00000001
1000011001
1000011001
1000011001
1000000001
1111011111
10CC001E11
1111111111
