11111
11111
11111
1CPE1
11111
1111